111111111111111111111111
10E000C0000C0000C0000001
10000CCC00CCC00CCC000001
100110C1110C1110C1110001
10C010000100001000010C01
1CCC1001110011100001CCC1
10C010000100001000010C01
10001C0111C01110C0010001
1000CCC00CCC000CCC000001
10000C0000C00000C00P0001
111111111111111111111111