111111111111111111111111111111111111111111111111111111111111111111111111111111111111111111111111111111111111111111111111
11000000000000E000P0C000000000000000000000000000000000C00000000000000000000000000000000000000000000000000000000000C00011
111111111111111111111111111111111111111111111111111111111111111111111111111111111111111111111111111111111111111111111111